NO ./assets/path_to_the_north_texture.txt    pelo
    SO ./assets/path_to_the_south_texture.txt
        WE    ./assets/path_to_the_west_texture.txt


EA ./assets/path_to_the_east_texture.txt

        F     0,255,0
 C       0,0,255

je
   suis
        la
           carte,
                  je suis la carte!
                  

        1111111111111111111111111
        1000000000110000000000001
        1011000001110000000000001
        1001000000000000000000001
111111111011000001110000000000001
100000000011000001110111101111111
11110111111111011100000010001
11110111111111011101010010001
11000000110101011100000010001
10000000000000001100000010001
10000000000000001101010010001
11000001110101011111011110S0111111111111
11110111 1110101 101111010001
11111111 1111111 111111111111
