NO ./assets/purplestone.xpm    pelo
    SO ./assets/mossy.xpm
        WE    ./assets/bluestone.xpm


EA ./assets/colorstone.xpm

        F     255,255,0
 C       0,0,0



    11111   1
    10001  101
    10001110001
    10E000000001
    10001110001
    10001  101
    11111   1